airplane	vliegtuig	avion
apple	appel	pomme
bear	beer	ours
bicycle	fiets	vélo
bird	vogel	oiseau
boat	boot	bateau
car	auto	voiture
cat	kat	chat
clock	klok	horloge
cow	koe	vache
dog	hond	chien
elephant	olifant	éléphant
flower	bloem	fleur
horse	paard	cheval
motorbike	motor	moto
mouse	muis	souris
scissors	schaar	ciseaux
sheep	schaap	mouton
sink	wasbak	couler
teddy	teddybeer	nounours
truck	vrachtauto	camion
umbrella	paraplu	parapluie
